19
22
185
21 2 2 2 2 2 2 16 2 2 2 16 2 2 2 2 2 2 20
3 1 1 1 1 1 1 3 1 1 1 3 1 1 1 1 1 1 3
3 1 21 2 2 9 1 11 1 10 1 11 1 8 2 2 20 1 3
3 1 3 1 1 1 1 1 1 3 1 1 1 1 1 1 3 1 3
3 -5 11 1 10 1 4 5 1 3 1 4 5 1 10 1 11 -5 3
3 1 1 1 3 1 6 7 1 11 1 6 7 1 3 1 1 1 3
22 2 9 1 3 1 1 1 1 1 1 1 1 1 3 1 8 2 23
0 1 1 1 22 9 1 8 2 2 2 9 1 8 23 1 1 1 0
10 1 10 1 1 1 0 0 0 0 0 0 0 1 1 1 10 1 10
3 1 22 9 1 10 0 21 2 24 2 20 0 10 1 8 23 1 3
3 1 1 1 1 3 0 3 0 0 0 3 0 3 1 1 1 1 3
3 1 10 1 8 23 0 22 2 2 2 23 0 22 9 1 10 1 3
3 1 3 1 1 1 0 0 0 0 0 0 0 1 1 1 3 1 3
3 1 22 9 1 21 2 9 1 10 1 8 2 20 1 8 23 1 3
3 1 1 1 1 3 1 1 1 3 1 1 1 3 1 1 1 1 3
19 9 1 10 1 11 1 8 2 17 2 9 1 11 1 10 1 8 18
3 1 1 3 1 1 1 1 1 0 1 1 1 1 1 3 1 1 3
3 -5 8 23 1 21 2 9 1 10 1 8 2 20 1 22 9 -5 3
3 1 1 1 1 3 1 1 1 3 1 1 1 3 1 1 1 1 3
3 1 8 9 1 3 1 8 2 17 2 9 1 3 1 8 9 1 3
3 1 1 1 1 3 1 1 1 1 1 1 1 3 1 1 1 1 3
22 2 2 2 2 17 2 2 2 2 2 2 2 17 2 2 2 2 23