19
22
173
2 2 2 2 2 16 2 2 2 2 2 2 2 16 2 2 2 2 2
1 1 1 1 1 3 1 1 1 1 1 1 1 3 1 1 1 1 1
21 2 2 9 1 11 1 8 2 16 2 9 1 11 1 8 2 2 20
3 -5 1 1 1 1 1 1 1 3 1 1 1 1 1 1 1 -5 3
3 1 21 2 2 9 1 10 1 3 1 10 1 8 2 2 20 1 3
3 1 3 1 1 1 1 3 1 11 1 3 1 1 1 1 3 1 3
3 1 11 1 8 20 1 3 1 1 1 3 1 21 9 1 11 1 3
3 1 1 1 1 3 1 22 2 2 2 23 1 3 1 1 1 1 3
19 2 2 9 1 3 0 0 0 0 0 0 0 3 1 8 2 2 18
3 1 1 1 1 3 0 21 2 24 2 20 0 3 1 1 1 1 3
3 1 8 20 1 11 0 3 0 0 0 3 0 11 1 21 9 1 3
3 1 1 3 1 0 0 22 2 2 2 23 0 0 1 3 1 1 3
22 20 1 3 1 10 0 0 0 0 0 0 0 10 1 3 1 21 23
0 3 1 11 1 22 9 0 4 12 5 0 8 23 1 11 1 3 0
0 3 1 1 1 1 1 1 14 0 15 1 1 1 1 1 1 3 0
2 23 1 8 2 16 9 1 6 13 7 1 8 16 2 9 1 22 2
0 0 1 1 1 3 1 1 1 0 1 1 1 3 1 1 1 0 0
21 9 1 10 1 11 1 8 2 16 2 9 1 11 1 10 1 8 20
3 -5 1 3 1 1 1 1 1 3 1 1 1 1 1 3 1 -5 3
3 1 8 23 1 8 2 9 1 11 1 8 2 9 1 22 9 1 3
3 1 1 1 1 1 1 1 1 1 1 1 1 1 1 1 1 1 3
22 2 2 2 2 2 2 2 2 2 2 2 2 2 2 2 2 2 23